D3D513D153
94552C5696
AFB92FFF83
AFC6857F86
AFFFAFFFAB
C13FAFD502
946FAFFF86
8555411783
A95394692A
C6D6C556C6

0,0
9,9
EWSSSSESWSEEEEESWSEEENES
